border_size=1
usage=map

Gll^Fp, Gll^Fp, Gll^Fp, Gll^Fp, Gll^Fp, Gll^Fp, Gll^Fp, Gll, Gll^Fp, Gll, Gll^Fp, Gll, Gll^Fp, Gll, Gll^Fp, Gll, Gll
Gll, Gll^Fp, Gll^Fp, Gll^Fp, Gll^Fp, Gll^Fp, Gll, Gll^Fp, Gll, Gll^Fp, Gll, Gll^Fp, Gll^Fp, Gll^Fp, Gll^Fp, Gll^Fp, Gll^Fp
Gll, Gll, Gll^Es, Gll, Gll, Gll, Gll, Gll, Gll, Gll, Gll, Gll^Fp, Gll^Fp, Gll^Fp, Gll^Fp, Gll^Fp, Gll^Fp
Gll, Gll, Gll, Gll, Gll, Gll, Gll^Es, Gll, Gll, Gll, Gll, Gll, Gll, Gll, Gll^Fp, Gll^Fp, Gll^Fp
Rp, Gll, Gll^Es, Gll, Gll, Gll^Es, Rp, Gll, Gll^Ecf, Gll, Gll, Gll, Gll, Gll, Gll, Gll^Fp, Gll^Fp
Rp, Gll, Rp, Rp, Rp, Rp, Gll, Rp, 1 Rp, Gll, Gll^Es, Gll, Gll, Gll^Es, Gll, Gll^Fp, Gll^Fp
Gll, Rp, Gll, Gll, Gll, Gll, Gll^Es, Gll, Gll, Rp, Gll, Gll, Gll, Gll, Gll, Gll^Fp, Gll^Fp
Gll^Fp, Gll, Gll, Gll^Es, Gll, Gll, Gll, Gll, Gll, Rp, Gll, Gll^Es, Gll, Gll^Es, Gll, Gll^Fp, Gll^Fp
Gll^Fp, Gll^Fp, Gll, Gll, Gll^Fp, Gll^Fp, Gll, Gll^Es, Gll, Rp, Gll, Gll, Gll^Es, Gll, Gll, Gll^Fp, Gll^Fp
Gll^Fp, Gll, Gll^Fp, Gll, Gll^Fp, Gll^Fp, Gll^Fp, Gll, Rp, Rp, Gll, Gll, Gll, Gll, Gll^Fp, Gll^Fp, Gll^Fp
Gll^Fp, Gll^Fp, Gll^Fp, Gll^Fp, Gll^Fp, Gll^Fp, Gll^Fp, Gll, Rp, Gll, Gll, Gll^Es, Gll, Gll, Gll^Fp, Gll^Fp, Gll^Fp
Gll, Gll^Fp, Gll, Gll^Fp, Gll, Gll^Fp, Gll, Gll, Rp, Gll, Gll, Gll^Fp, Gll^Fp, Gll^Fp, Gll^Fp, Gll^Fp, Gll^Fp
