border_size=1
usage=map

Xu, Xu, Xu, Xu, Xu, Xu, Xu, Xu, Xu, Xu, Xu, Xu, Xu, Xu, Xu, Xu, Uu, Xu, Xu, Xu, Xu, Xu, Xu, Xu, Xu, Xu, Xu, Xu, Xu, Xu, Xu, Xu, Xu, Xu
Xu, Xu, Xu, Xu, Xu, Xu, Xu, Xu, Xu, Xu, Xu, Xu, Xu, Xu, Xu, Uu, Uu, Xu, Xu, Xu, Xu, Xu, Xu, Xu, Xu, Xu, Xu, Xu, Xu, Xu, Xu, Xu, Xu, Xu
Xu, Xu, Xu, Xu, Xu, Xu, Xu, Xu, Xu, Xu, Xu, Xu, Xu, Xu, Xu, Uu, Uu, Xu, Xu, Xu, Xu, Xu, Xu, Xu, Xu, Xu, Xu, Xu, Xu, Xu, Xu, Xu, Xu, Xu
Xu, Xu, Xu, Xu, Xu, Uu^Dr, Uu^Dr, Xu, Uu^Edb, Xu, Xu, Xu, Xu, Xu, Uu, Uu, Uu, Xu, Xu, Xu, Xu, Xu, Xu, Xu, Xu, Xu, Xu, Xu, Xu, Xu, Xu, Xu, Xu, Xu
Xu, Xu, Xu, Xu, Uu^Edb, Uu^Dr, Uu^Edb, Uu^Edb, Uu^Edb, Uu^Edb, Uu^Edt, Uu^Edt, Uu^Edt, Uu, Uu, Uu, Uu, Uu, Uu, Xu, Xu, Xu, Xu, Xu, Xu, Xu, Xu, Xu, Xu, Xu, Xu, Xu, Xu, Xu
Xu, Xu, Xu, Xu, Uu^Edb, Uu^Edb, Uu^Edb, Uu^Edb, Uu^Vu, Uu^Edt, Uu^Edt, Uu^Edt, Uu^Edt, Uu, Co, Co, Co, Uu, Uu, Uu, Uu^Uf, Xu, Xu, Xu, Xu, Xu, Xu, Xu, Xu, Xu, Xu, Xu, Xu, Xu
Xu, Xu, Xu, Uu^Edb, Uu^Edb, Uu^Edb, Uu^Edt, Uu^Edt, Uu^Edt, Uu^Edt, Uu^Edt, Uu^Edt, Uu, Uu, Co, 2 Ko, Co, Uu, Uu, Uu, Uu, Xu, Xu, Xu, Xu, Xu, Xu, Xu, Xu, Xu, Xu, Xu, Xu, Xu
Xu, Xu, Uu^Edb, Uu^Edb, Uu^Edt, Uu^Edt, Uu^Edt, Uu^Edt, Uu^Es, Uu^Edt, Uu^Edt, Uu, Uu^Edt, Uu, Uu, Co, Uu, Uu, Uu, Uu, Uu, Xu, Xu, Xu, Xu, Xu, Xu, Xu, Xu, Xu, Xu, Xu, Xu, Xu
Xu, Xu, Xu, Uu^Edt, Uu^Edt, Uu^Edt, Uu, Uu, Uu^Edt, Uu^Edt, Uu^Edt, Uu^Edt, Uu, Uu^Edt, Uu, Uu, Uu, Uu, Uu, Uu, Uu, Xu, Ur, Xu, Xu, Xu, Ur, Xu, Xu, Xu, Xu, Xu, Xu, Xu
Xu, Xu, Xu, Uu, Uu^Edt, Uu^Edt, Uu^Edt, Uu^Edt, Uu, Uu^Edt, Uu, Uu, Uu, Uu, Uu, Uu, Uu, Uu, Uu^Vu, Uu, Uu, Ur, Xu, Ur, Ur, Ur, Uu^Vu, Ur, Ur, Xu, Xu, Xu, Xu, Xu
Xu, Xu, Xu, Uu, Uu^Edt, Uu^Edt, Uu, Uu, Uu^Vu, Uu, Uu, Uu, Uu, Uu, Uu, Uu, Uu, Uu, Uu, Uu, Ur, Ur, Ur, Ur, Uu, Uu, Xu, Uu, Uu, Ur, Ur, Xu, Xu, Xu
Xu, Xu, Xu, Uu, Uu^Es, Uu^Es, Uu^Es, Uu, Uu, Uu, Uu, Uu, Uu, Uu, Uu, Uu, Uu, Uu, Uu, Uu, Ur, Ur, Uu, Uu, Xu, Xu, Xu, Xu, Xu, Uu, Uu, Ur, Ur, Xu
Xu, Xu, Xu, Uu, Uu, Uu, Uu, Uu, Uu, Uu, Uu, Uu, Uu, Uu, Uu, Uu, Uu, Uu, Ur, Ur, Uu, Uu, Xu, Xu, Xu, Xu, Xu, Xu, Xu, Xu, Xu, Uu, Uu, Ur
Xu, Xu, Uu, Uu^Es, Uu, Uu^Es, Uu, Uu, Uu^Es, Uu^Es, Uu, Uu^Es, Uu, Uu, Uu, Uu, Ur, Ur, Uu, Uu, Uu, Uu, Uu, Uu, Uu, Xu, Xu, Xu, Xu, Xu, Xu, Xu, Xu, Uu
Xu, Xu, Uu^Vu, Uu, Xu, Uu, Uu, Uu, Uu, Uu, Uu, Uu, Uu, Uu, Ur, Ur, Uu, Uu, Xu, Xu, Uu, Uu, Uu^Es, Uu, Uu^Es, Uu, Uu, Xu, Xu, Xu, Xu, Xu, Xu, Xu
Xu, Xu, Xu, Xu, Xu, Xu, Xu, Uu, Uu^Vu, Uu, Xu, Xu, Ur, Ur, Uu, Uu, Xu, Xu, Uu, Uu, Uu, Uu^Es, Uu^Vu, Uu, Uu, Uu, Uu, Uu, Uu, Xu, Xu, Xu, Xu, Xu
Xu, Xu, Xu, Xu, Xu, Xu, Xu, Xu, Xu, Xu, Ur, Ur, Uu, Uu, Xu, Xu, Xu, Xu, Uu, Uu, Uu, Uu, Uu, Uu, Uu, Uu, Uu, Uu, Uu^Es, Uu, Xu, Xu, Xu, Xu
Xu, Xu, Xu, Xu, Xu, Xu, Xu, Xu, Ur, Ur, Uu, Uu, Xu, Xu, Xu, Xu, Xu, Xu, Uu, Uu, Uu^Es, Uu^Es, Uu^Es, Uu, Co, Co, Co, Uu, Uu, Uu, Xu, Xu, Xu, Xu
Xu, Xu, Xu, Xu, Xu, Xu, Ur, Ur, Uu, Uu^Es, Uu, Uu, Uu^Vu, Xu, Xu, Xu, Xu, Xu, Uu, Uu, Uu, Uu^Es, Uu, Uu, Co, 3 Ko, Co, Uu, Uu^Es, Uu, Xu, Xu, Xu, Xu
Xu, Xu, Xu, Xu, Ur, Ur, Ce, Ce, Ce, Uu, Uu^Es, Uu, Xu, Xu, Xu, Xu, Xu, Xu, Xu, Uu, Uu, Uu^Es, Uu, Uu, Uu, Co, Uu, Uu, Uu, Uu, Xu, Xu, Xu, Xu
Xu, Xu, Ur, Ur, Uu, Uu, Ce, 1 Ke, Uu, Uu, Xu, Xu, Xu, Xu, Xu, Xu, Xu, Xu, Xu, Xu, Xu, Uu, Uu, Uu^Es, Uu, Uu, Uu, Uu, Xu, Xu, Xu, Xu, Xu, Xu
Ur, Ur, Uu, Uu^Es, Uu^Es, Uu, Uu, Uu, Xu, Xu, Xu, Xu, Xu, Xu, Xu, Xu, Xu, Xu, Xu, Xu, Xu, Xu, Xu, Uu, Uu, Uu, Xu, Xu, Xu, Xu, Xu, Xu, Xu, Xu
Uu, Uu, Uu, Uu, Uu, Uu, Xu, Xu, Xu, Xu, Xu, Xu, Xu, Xu, Xu, Xu, Xu, Xu, Xu, Xu, Xu, Xu, Xu, Xu, Xu, Xu, Xu, Xu, Xu, Xu, Xu, Xu, Xu, Xu
