border_size=1
usage=map

Xu, Xu, Xu, Xu, Xu, Xu, Xu, Xu, Xu, Xu, Xu, Xu, Xu, Xu, Xu, Xu, Xu, Xu, Xu, Xu, Xu, Xu, Xu, Xu, Xu, Xu, Xu, Xu, Xu, Xu, Ur, Xu
Xu, Xu, Xu, Xu, Xu, Xu, Xu, Xu, Xu, Xu, Xu, Xu, Xu, Xu, Xu, Xu, Xu, Xu, Xu, Xu, Xu, Xu, Xu, Xu, Xu, Xu, Xu, Xu, Xu, Xu, Ur, Uu
Xu, Xu, Xu, Xu, Xu, Xu, Xu, Xu, Xu, Xu, Xu, Xu, Xu, Xu, Xu, Xu, Xu, Xu, Ur, Xu, Xu, Xu, Xu, Xu, Xu, Xu, Xu, Xu, Xu, Xu, Ur, Uu
Xu, Xu, Xu, Xu, Xu, Xu, Xu, Xu, Xu, Xu, Xu, Xu, Xu, Xu, Xu, Xu, Ur, Ur, Uu^Edb, Ur, Ur, Uu, Uu, Xu, Xu, Xu, Xu, Xu, Xu, Xu, Ur, Uu
Xu, Xu, Xu, Xu, Xu, Xu, Xu, Xu, Xu, Xu, Xu, Xu, Xu, Xu, Ur, Ur, Uu, Uu, Uu^Es, Uu^Edb, Uu^Edb, Ur, Ur, Uu, Xu, Xu, Xu, Xu, Ur, Ur, Uu^Edt, Uu
Xu, Xu, Xu, Xu, Xu, Xu, Xu, Xu, Xu, Xu, Xu, Xu, Ur, Ur, Uu, Uu^Edt, Uu^Edt, Uu^Edt, Uu, Uu, Uu, Uu, Uu^Edb, Ur, Ur, Xu, Ur, Ur, Uu, Uu^Es, Xu, Uu
Xu, Xu, Xu, Xu, Xu, Xu, Xu, Xu, Xu, Xu, Ur, Ur, Uu, Uu, Uu^Vu, Uu, Uu, Uu^Edb, Co, Co, Co, Uu, Uu^Edt, Uu^Edb, Uu, Ur, Uu^Vu, Uu, Uu^Edt, Uu, Xu, Xu
Xu, Xu, Xu, Xu, Xu, Xu, Xu, Xu, Ur, Ur, Uu, Uu, Uu^Es, Uu, Uu^Edt, Uu, Uu, Uu^Edb, Co, 2 Ko, Co, Uu^Edt, Uu^Edt, Uu, Uh, Uu, Uh, Uu, Uu^Edt, Uu, Xu, Xu
Xu, Xu, Uu, Xu, Uu, Xu, Ur, Ur, Uu, Ur, Ur, Uu, Uu^Es, Uu^Edt, Uu^Edt, Uu, Uu, Uu^Edb, Uh, Co, Uh, Uu^Edt, Uu, Uh, Uh, Uh, Uh, Uu, Uu^Edt, Uu, Xu, Xu
Uu, Uu, Uu, Uu, Ur, Ur, Uu, Uu, Uu, Uu, Uu, Ur, Ur, Uu^Edt, Uu^Edt, Uu, Uu, Uh, Uh, Uh, Uh, Uu^Edt, Uu^Edt, Uh, Uu, Uh, Uu^Vu, Uu, Uu, Uu, Xu, Xu
Uu, Uu, Ur, Ur, Cud, Cud, Cud, Uu, Uu, Uu, Uu^Vud, Uu, Uu, Ur, Ur, Uu, Uu, Uu, Uu^Vu, Uu, Uu, Uu^Edt, Uu^Edt, Uu, Uu, Uu^Edt, Uu, Uu, Uu, Uu, Xu, Xu
Ur, Ur, Uu, Uu, Cud, 1 Kud, Cud, Uu, Uu, Uu, Uu, Uu, Uu, Uu^Es, Uu^Edt, Ur, Ur, Uu, Uu^Edt, Uu, Uu^Edt, Uu, Uu^Edt, Uu, Uu^Edt, Uu, Uu, Uu, Uu, Xu, Xu, Xu
Uu, Uu, Uu, Uu, Uu, Cud, Uu, Uu, Uu, Uu, Uu, Uu, Uu, Uu, Uu, Uu, Uu, Ur, Ur, Uu^Edt, Uu, Uu^Edt, Uu, Uu^Edt, Uu, Uu^Edt, Uu, Uu, Xu, Xu, Xu, Xu
Xu, Uu, Xu, Uu, Xu, Uu, Xu, Uu, Xu, Uu, Xu, Xu, Xu, Uu, Uu, Uu, Uu, Uu, Uu, Ur, Ur, Uu, Uu, Xu, Xu, Xu, Xu, Xu, Xu, Xu, Xu, Xu
Xu, Xu, Xu, Xu, Xu, Xu, Xu, Xu, Xu, Xu, Xu, Xu, Xu, Xu, Xu, Xu, Xu, Xu, Xu, Uu, Uu, Ur, Ur, Uu, Uu, Xu, Xu, Xu, Xu, Xu, Xu, Xu
Xu, Xu, Xu, Xu, Xu, Xu, Xu, Xu, Xu, Xu, Xu, Xu, Xu, Xu, Xu, Xu, Xu, Xu, Xu, Xu, Xu, Uu, Uu, Ur, Ur, Uu, Uu, Xu, Xu, Xu, Xu, Xu
Xu, Xu, Xu, Xu, Xu, Xu, Xu, Xu, Xu, Xu, Xu, Xu, Xu, Xu, Xu, Xu, Xu, Xu, Xu, Xu, Xu, Xu, Xu, Uu, Uu, Ur, Ur, Uu, Uu, Xu, Xu, Xu
Xu, Xu, Xu, Xu, Xu, Xu, Xu, Xu, Xu, Xu, Xu, Xu, Xu, Xu, Xu, Xu, Xu, Xu, Xu, Xu, Xu, Xu, Xu, Xu, Xu, Uu, Uu, Ur, Ur, Uu, Uu, Xu
