border_size=1
usage=map

Xu, Xu, Xu, Xu, Xu, Xu, Xu, Xu, Uu, Uu, Ur, Uu, Uu, Xu, Xu, Xu, Xu, Xu, Xu
Xu, Xu, Xu, Xu, Xu, Xu, Ql, Uu, Uu, Uu^Cov, 2 Ur^Kov, Uu^Cov, Uu, Uu, Ql, Xu, Xu, Xu, Xu
Xu, Xu, Xu, Xu, Ql, Ql, Ql, Ql, Ql, Uu, Ur, Uu, Ql, Ql, Ql, Ql, Ql, Xu, Xu
Xu, Xu, Xu, Xu, Ql, Ql, Ql, Ql, Ql, Uu, Ur, Uu, Ql, Ql, Ql, Ql, Ql, Xu, Xu
Xu, Xu, Xu, Xu, Ql, Ql, Ql, Ql, Ql, Uu, Ur, Uu, Ql, Ql, Ql, Ql, Ql, Xu, Xu
Xu, Xu, Xu, Xu, Uu, Ql, Ql, Ql, Uu, Uu, Ur, Uu, Uu, Ql, Ql, Ql, Uu, Xu, Xu
Xu, Xu, Xu, Xu, Ur, Uu, Ur, Uu, Ur, Ur, Ur, Ur, Ur, Ur, Ur, Ur, Ur, Xu, Xu
Xu, Xu, Xu, Xu, Uu, Ur, Ql, Ur, Uu, Uu, Ur, Uu, Uu, Uu, Ql, Uu, Uu, Xu, Xu
Xu, Xu, Xu, Xu, Ql, Ql, Ql, Ql, Ql, Uu, Ur, Uu, Ql, Ql, Ql, Ql, Ql, Xu, Xu
Xu, Xu, Xu, Xu, Ql, Ql, Ql, Ql, Ql, Uu, Ur, Uu, Ql, Ql, Ql, Ql, Ql, Xu, Xu
Xu, Xu, Xu, Xu, Ql, Ql, Ql, Ql, Ql, Uu, 1 Ur, Uu, Ql, Ql, Ql, Ql, Ql, Xu, Xu
Xu, Xu, Xu, Xu, Xu, Ql, Ql, Ql, Uu, Uu, Ur, Uu, Uu, Ql, Ql, Ql, Xu, Xu, Xu
Xu, Xu, Xu, Xu, Xu, Xu, Xu, Xu, Uu, Uu, Uu, Uu, Uu, Xu, Xu, Xu, Xu, Xu, Xu
