border_size=1
usage=map

Hh, Hh, Hh, Hh, Gg, Hh, Hh, Hh, Gg, Hh, Gg, Hh, Gg, Gg, Gg, Gg, Gg, Gg, Gg, Gg, Gg, Rd, Gg, Gg, Gg, Gg, Gg, Ss, Ss, Ss, Ww, Ss, Ss, Ss, Ss, Ww, Ss, Ss, Ss, Ss, Ww, Ww, Ss, Ss, Ww, Ss, Gs^Fp, Gs^Fp, Gs^Fp, Gs^Fp, Gs^Fp, Gs^Fp, Gs^Fp, Gs^Fp, Gs^Fp, Gs^Fp, Gs^Fp, Gs^Fp, Gs^Fp, Gs^Fp
Hh, Hh, Hh, Hh, Gg, Hh, Hh, Hh, Gg, Hh, Gg, Hh, Gg, Gg, Gg, Gg, Gg, Gg, Gg, Gg, Gg, Rd, Gg, Gg, Gg, Gg, Gg, Ss, Ss, Ss, Ww, Ss, Ss, Ss, Ss, Ww, Ss, Ss, Ss, Ss, Ww, Ww, Ss, Ss, Ww, Ss, Gs^Fp, Gs^Fp, Gs^Fp, Gs^Fp, Gs^Fp, Gs^Fp, Gs^Fp, Gs^Fp, Gs^Fp, Gs^Fp, Gs^Fp, Gs^Fp, Gs^Fp, Gs^Fp
Hh, Hh, Hh, Hh, Gg, Gg, Gg, Gg, Gg, Gg, Gg, Gg, Gg, Gg, Gg, Gg, Gg, Gg, Gg, Gg, Gg, Rd, Gg, Gs^Fp, Gg, Gg, Gs^Fp, Gg, Ss, Ss, Ss, Ww, Ss, Ss, Ww, Ss, Gg, Ss, Ss, Ww, Ss, Ss, Gg, Ss, Ss^Vhs, Ss, Gs^Fp, Gg, Gg, Gs^Fp, Gs^Fp, Gs^Fp, Gs^Fp, Gs^Fp, Gs^Fp, Gs^Fp, Gs^Fp, Gs^Fp, Gs^Fp, Gs^Fp
Gg, Gg, Gg, Hh, Gg, Gg, Gg^Edb, Gg, Gg^Edb, Gg^Edb, Gg^Edb, Gg, Gg^Edb, Gg, Gg, Gg, Gg, Gg, Gg, Gg, Gg, Rd, Gg, Gs^Fp, Gg, Gs^Fp, Gs^Fp, Gg, Gg, Ss, Ss, Ww, Ss, Ww, Ss, Ss, Ss, Gg, Ss, Ww, Ss, Ss, Ss, Ss, Ss, Ss, Ss, Ss, Gs^Fp, Gs^Fp, Gs^Fp, Gs^Fp, Gs^Fp, Gs^Fp, Gs^Fp, Gs^Fp, Gs^Fp, Gs^Fp, Gs^Fp, Gs^Fp
Gg, Gg, Gg, Gg, Gg, Gg^Edb, Gg^Edb, Gg^Edb, Gg^Edb, Gg^Edb, Gg^Edb, Gg^Edb, Gg^Edb, Gg, Gg, Gs^Vh, Gg, Gg, Gg, Gg, Gg, Rd, Gg, Gg, Gg, Gs^Fp, Gg, Gs^Fp, Gg, Gg, Ww, Ww, Ww, Ww, Gg, Ss, Ss, Ss, Ww, Ww, Ss, Ss, Ss, Ss, Gs^Fp, Gs^Fp, Gs^Fp, Gs^Fp, Gg, Ss, Gs^Fp, Gs^Fp, Gs^Fp, Gs^Fp, Gs^Fp, Gs^Fp, Gs^Fp, Gs^Fp, Gs^Fp, Gs^Fp
Gg, Gg, Gg^Edb, Gg, Gg, Gg^Edb, Gg^Edb, Gg, 9 Kh, Gg^Edb, Gg^Edb, Gg, Gg^Edb, Gg^Edb, Gg, Gg, Gg, Gg, Gg, Gg, Gg, Rd, Rd, Gg, Gg, Gg, Ww, Gg, Ww, Ww, Ww, Ss, Ss, Ss, Gg, Ss^Vhs, Ss, Ww, Ss, Ss, Gg, Gg, Ss, Ss, Ss, Gs^Fp, Gg, Gs^Fp, Gs^Fp, Gg, Gs^Fp, Gs^Fp, Gs^Fp, Gs^Fp, Gs^Fp, Gs^Fp, Gs^Fp, Gs^Fp, Gs^Fp, Gs^Fp
Gg, Gg, Gg, Gg, Gg, Gg^Edb, Gg^Edb, Ch, Ch, Ch, Gg, Gg^Edb, Gg^Edb, Gg^Edb, Gg, Gg, Gg, Gg, Gg, Gg, Gg, Gg, Gg, Rd, Ww^Bw\, Ww, Gg, Ww, Gg, Gg, Gg, Ww, Ww, Ww, Ww, Ww, Ss, Ss, Ss, Gg, Ss, Gg, Ss, Gg, Gs^Fp, Ss, Ss, Gs^Fp, Gs^Fp, Gs^Fp, Gs^Fp, Gs^Vh, Gs^Fp, Gs^Fp, Gs^Fp, Gs^Fp, Gs^Fp, Gs^Fp, Gs^Fp, Gs^Fp
Gg, Gg, Gg, Gg, Gg, Gg^Edb, Gg, Gg^Edb, Gg, Gg^Edb, Gg^Edb, Gg, Gg^Edb, Gg^Edb, Gg, Gg, Gg, Gg, Gg, Gg, Gg, Gg, Gg, Ww, Gg, Rd, Gg, Gg, Gg, Gg, Gg, Gg, Gg, Ss, Ss, Ss, Ss, Ss, Ss, Ss, Ss, Ss, Gs^Fp, Gg, Gs^Fp, Gg, Ss, Gg, Gs^Fp, Gs^Fp, Gs^Fp, Gs^Fp, Gs^Fp, Gs^Fp, Gs^Fp, Gs^Fp, Gs^Fp, Gs^Fp, Gs^Fp, Gs^Fp
Gs^Fp, Gs^Fp, Gg, Gg, Gg, Gg, Gg^Edb, Gg^Edb, Gg^Edb, Gg, Gg^Edb, Gg^Edb, Gg, Gg, Gg, Gs^Vh, Gg, Gg, Gg, Gg, Gg, Gg, Ww, Ww, Gg, Rr, Gg, Gg, Gg, Gg, Gg, Gg, Gg, Gg, Gg, Gg, Gg, Gg, Gg, Ss, Gg, Gg, Gs^Fp, Gs^Fp, Gs^Fp, Gs^Fp, Gs^Fp, Gg, Gs^Fp, Gs^Fp, Gs^Fp, Gs^Fp, Gs^Fp, Gs^Fp, Gs^Fp, Gs^Fp, Gs^Fp, Gs^Fp, Gs^Fp, Gs^Fp
Gg, Gg, Gg, Gg, Gg, Gs^Vh, Gg, Gg, Gg^Edb, Gg, Gg, Gg, Gg, Gg, Gg, Gg, Gg, Gg, Gg, Gg, Ww, Ww, Gg, Gg, Gg, Rr, Gg, Gg, Gg, Gg, Gg, Gg, Gg, Gg, Gg, Gg, Gg, Gg, Gg, Gg, Gg, Gg, Gs^Fp, Gs^Fp, Gs^Fp, Gs^Fp, Gs^Fp, Gs^Fp, Gs^Fp, Gs^Fp, Gs^Fp, Gs^Fp, Gs^Fp, Gs^Fp, Gs^Fp, Gs^Fp, Gs^Fp, Gs^Fp, Gs^Fp, Gs^Fp
Gg, Gg, Gg, Gg, Gg, Gg, Gg, Gg, Gg^Edb, Gg, Gg, Gg, Gg, Gg, Gg, Gg, Gg, Gg, Gg, Ww, Gg, Gg, Gg, Ch, Gg, Rr, Gg, Ch, Gg, Gg, Gg, Gg, Gg, Gg, Gg, Gg, Gg, Gg, Gg, Gg, Gg, Gs^Fp, Gs^Fp, Gs^Fp, Gs^Fp, Gs^Fp, Gs^Fp, Gs^Fp, Gs^Fp, Gs^Fp, Gs^Fp, Gs^Fp, Gs^Fp, Gs^Fp, Gs^Fp, Gs^Fp, Gg, Gg, Gs^Fp, Gs^Fp
Gg, Gg, Gg, Gg, Gg, Gg, Gg, Gg, Gg, Gg, Gg, Gg, Gs^Fp, Gg, Gg, Gg, Gg, Gg, Ww, Ww, Gg, Gg, Ch, Ch, Gg, Rr, Gg, Ch, Ch, Gg, Gg, Gg, Gg, Gg, Gg, Gg, Gg, Gg, Gg, Gg, Gg, Gs^Fp, Gs^Fp, Gs^Fp, Gs^Fp, Gs^Fp, Gs^Fp, Gs^Fp, Gs^Fp, Gs^Fp, Gs^Fp, Gs^Fp, Gs^Fp, Gs^Fp, Gs^Fp, Gs^Fp, Gg, Gs^Fp, Gs^Fp, Gs^Fp
Gg, Gg, Gg, Gg, Gg, Gg, Gg, Gg, Gg, Gg, Gg, Gs^Fp, Gs^Fp, Gs^Fp, Gg, Gg, Gg, Gg, Ww, Gg, Ch, Ch, Gg^Vh, Ch, Gg, Rr, Gg, Ch, Gg, Ch, Ch, Gg, Gg, Gg, Gg, Gg, Gg, Gg, Gg, Gg, Gg, Gs^Fp, Gs^Fp, Gs^Fp, Gs^Fp, Gs^Fp, Gs^Fp, Gs^Fp, Gs^Fp, Gs^Fp, Gs^Fp, Gs^Fp, Gg, Gs^Fp, Gg, Gs^Fp, Gg, Gs^Fp, Gs^Fp, Gs^Fp
Gg, Gg, Gs^Fp, Gs^Fp, Gs^Fp, Gg, Gg, Gg, Gs^Fp, Gg, Gs^Fp, Gs^Fp, Gs^Fp, Gg, Gg, Gg, Ww, Ww, Ch, Ch, Gg, Ch, Gg, Gg, Rr, Rr, Gg, Gg, Gg^Vh, Ch, Gg, Ch, Ch, Gg, Gg, Gg, Gg, Gg, Gg, Gg, Gg, Gg, Gs^Fp, Gs^Fp, Gs^Fp, Gs^Fp, Gs^Fp, Gs^Fp, Gs^Fp, Gs^Fp, Gs^Fp, Gs^Fp, Gs^Fp, Gg, Gs^Fp, Gg, Gs^Fp, Gs^Fp, Gs^Fp, Gs^Fp
Gg, Gg, Gg, Gs^Fp, Gg^Vh, Gg, Gs^Fp, Gg, Gg, Gs^Fp, Gs^Fp, Gs^Fp, Re, Gg, Gg, Gg, Ww, Ch, Gg, Gg, Gg, Ch, Ch, Gg, Rr, Gg, Gg, Gg, Ch, Ch, Gg, Gg, Gg, Ch, Ch, Gg, Gg, Gg, Gg, Gg, Gs^Fp, Gg, Gs^Fp, Gs^Fp, Gs^Fp, Gs^Fp, Gs^Fp, Gs^Fp, Gs^Fp, Gs^Fp, Gs^Fp, Gs^Fp, Gs^Fp, Gg, Gg, Gs^Fp, Gs^Fp, Gs^Fp, Gs^Fp, Gs^Fp
Hh, Hh, Hh, Gg, Gg, Gs^Fp, Gs^Fp, Gs^Fp, Re, Gg, Re, Re, Gg, Gg, Ch, Ch, Gg, Ww, Gg, Gg^Vh, Gg, Gg, Gg, Gg, Gg, Rr, Gg, Ch, Gg, Gg, Gg, Gg, Gg, Gg, Gg, Ch, Ch, Gg, Gg, Gs^Fp, Gs^Fp, Gg, Gs^Fp, Gs^Fp, Gs^Fp, Gs^Fp, Gs^Fp, Gs^Fp, Gs^Fp, Gs^Fp, Gs^Fp, Gs^Fp, Gs^Fp, Gs^Fp, Gg, Gs^Fp, Gs^Fp, Gs^Fp, Gs^Fp, Gs^Fp
Hh, Hh, Hh, Gg, Gg, Gg, Re, Re, Gs^Fp, Re, Gs^Fp, Gs^Fp, Gg, Gg, Ch, Gg, Gg, Ww, Gg, Gg, Gg, Gg, Gg, Gg, Gg, Rr, Rr, Gg, Gg, Gg, Gg, Gg, Rr, Gg, Gg^Vh, Gg, Gg, Gg, Gg, Gg, Gg, Gg, Gg, Gs^Fp, Gs^Fp, Gs^Fp, Gs^Fp, Gs^Fp, Gs^Fp, Gs^Fp, Gg, Gg, Gg, Gs^Fp, Gs^Fp, Gg, Gs^Fp, Gs^Fp, Gs^Fp, Gs^Fp
Hh, Hh, Gg, Hh, Gg, Re, Gg, Gs^Fp, Gs^Fp, Re, Gg, Gg, Ch, Ch, Gg, Gg, Gg, Ww, Ww^Bw/, Gg, Gg, Gg, Ch, Gg, Ch, Ch, Rr, Ch, Ch, Gg, Ch, Gg, Rr, Gg, Gg, Gg, Gg, Ch, Gg, Gg, Gg, Gg, Gs^Fp, Gg, Gg, Gs^Fp, Gs^Fp, Gs^Fp, Gs^Fp, Gg, Gs^Fp, Gs^Fp, Gs^Fp, Gg, Gg, Gg, Gg, Gs^Fp, Gs^Fp, Gs^Fp
Hh, Hh, Gg, Gg, Gg, Gg, Gs^Fp, Gs^Fp, Gg, Re, Gg, Gg, Ch, Gg, Gg, Gg, Gg^Vh, Gg, Gg, Ww, Gg, Gg, Gg, 4 Kh, Rr, Rr, Rr, Rr, Rr, 6 Kh, Gg, Gg, Rr, Gg, Gg, Gg, Gg, Ch, Gg, Gg, Gg, Gs^Fp, Gg, Gg, Gs^Fp, Gs^Fp, Gs^Fp, Gs^Fp, Gs^Fp, Gs^Fp, Gs^Fp, Gs^Fp, Gs^Fp, Gs^Fp, Gs^Fp, Gs^Fp, Gg, Gs^Fp, Gs^Fp, Gs^Fp
Gg, Gg, Gg, Gg^Vh, Gg, Gg, Gg, Gs^Fp, Gg, Re, Gg, Ch, Gg, Gg, Gg, Hh, Hh, Gg, Gg, Ww, Gg, Gg, Gg, Ch, Rr, Rr, Ch, Rr, Rr, Ch, Rr, Rr, Ch, Rr, Rr, Gg, Gg, Ch, Gg, Gg, Gg, Gs^Fp, Gg, Gs^Fp, Gs^Fp, Gs^Fp, Gs^Fp, Gs^Fp, Gs^Fp, Gs^Fp, Gs^Fp, Gs^Fp, Gs^Fp, Gs^Fp, Gg, Gg, Ch, Gs^Fp, Gs^Fp, Gs^Fp
Hh, Hh, Gg, Gg, Gg, Gg, Gg, Gg, Gg, Gg, Gg, Gg, Ch, Gg, Gg, Hh, Gg, Gg, Gg, Ww, Gg, Gg, Gg, Ch, Rr, Ch, 2 Kh, Ch, Rr, Rr, Ch, Ch, Gg, Gg, Rr, Gg, Gg, Ch, Gg, Gg, Gg, Gg, Gg, Gg^Vh, Gs^Fp, Gs^Fp, Gs^Fp, Gs^Fp, Gs^Fp, Gs^Fp, Gs^Fp, Gs^Fp, Gg, Gg, Gs^Fp, Ch, 8 Kh, Ch, Gs^Fp, Gs^Fp
Hh, Hh, Hh, Hh, Gg, Gg, Gg, Gg, Gg, Gg, Gg, Ch, Gg, Gg, Gg, Hh, Gg, Gg, Ww, Ww, Gg, Gg, Rr, Rr, Rr, Ch, Ch, Ch, Rr, Rr, 7 Kh, Gg, Gg, Gg, Rr, Gg^Vh, Gg, Ch, Ch, Gg, Gg, Gs^Fp, Gg, Gg, Gg, Gs^Fp, Gg, Gs^Fp, Gg, Gs^Fp, Gg^Vh, Gg, Gs^Fp, Gs^Fp, Gs^Fp, Ch, Ch, Ch, Gs^Fp, Gs^Fp
Hh, Hh, Gg^Vh, Gg, Gg, Hh, Gg, Hh, Gg, Gg, Gg, Ch, Ch, Gg, Gg, Gg, Gg, Gg, Ww^Bw/, Gg, Gg, Rr, Ch, Ch, 5 Kh, Rr, Rr, Rr, Rr, Rr, Ch, Gg, Gg, Gg, Gg, Rr, Re, Ch, Gg, Gg, Gg, Gg, Rd, Gs^Fp, Gs^Fp, Gg, Rd, Rd, Rd, Gg, Gg, Gg, Gs^Fp, Gs^Fp, Gs^Fp, Gg, Gg, Gs^Fp, Rd, Rd
Hh, Hh, Hh, Hh, Hh, Gg^Vh, Hh, Hh, Hh, Gg, Gg, Gg, Gg, Ch, Gg, Gg, Gg, Gg, Ww, Gg, Ww, Gg, Gg, Gg, Gg, Ch, Rr, Rr, Rr, Gg, Gg, Ch, Ch, Gg, Gg, Gg, Gg, Re, Rd, Gg, Rd, Rd, Gg, Rd, Rd, Rd, Gg, Gg, Gg, Rd, Rd, Rd, Rd, Gg, Gg, Gg, Rd, Rd, Gg, Gg
Mm, Mm, Mm, Mm, Mm, Hh, Hh, Hh, Gg, Gg, Gg, Gg, Gg, Ch, Gg, Gg, Gg, Gg, Gg, Ww, Ww, Ww, Gg, Gg, Gg, Ch, Ch, Gg, Rr, Gg, Gg, Gg, Gg, Gg, Gg, Gg, Ch, Gg, Gg, Rd, Gg, Gg, Gs^Fp, Gg, Gg, Gg, Gs^Fp, Gg, Gs^Fp, Gs^Fp, Gs^Fp, Gg, Gg, Rd, Rd, Rd, Gg^Vh, Gs^Fp, Gs^Fp, Gs^Fp
Mm, Mm, Hh, Mm, Mm, Hh, Hh, Hh, Hh, Hh, Gg, Gg, Gg, Gg, Ch, Gg, Gg, Gg^Vh, Gg, Gg, Ww, Ww, Ww, Gg, Gg, Gg, Gg, Gg, Rr, Gg, Gs^Fp, Gs^Fp, Gg, Gg, Gg, Gg, Gg, Ch, Gg, Gg, Gg, Gs^Fp, Gs^Fp, Gg, Gs^Fp, Gs^Fp, Gs^Fp, Gs^Fp, Gs^Fp, Gs^Fp, Gs^Fp, Gs^Fp, Gs^Fp, Gg, Gs^Fp, Gs^Fp, Gs^Fp, Gs^Fp, Gs^Fp, Gs^Fp
Hh, Hh, Hh, Mm, Hh, Mm, Hh, Hh, Gg, Hh, Gg, Gg, Gg, Gg, Ch, Gg, Gg, Gg, Gg, Ww^Bw\, Gg, Ww, Gg, Gg, Gs^Fp, Gg, Rr, Rr, Gs^Fp, Gg, Gg^Vh, Gs^Fp, Gg, Gg, Gg, Gg, Ch, Ch, Gg, Gg, Gs^Fp, Gg, Gs^Fp, Gg, Gs^Fp, Gs^Fp, Gs^Fp, Gs^Fp, Gs^Fp, Gs^Fp, Gs^Fp, Gs^Fp, Gs^Fp, Gs^Fp, Gs^Fp, Gs^Fp, Gs^Fp, Gs^Fp, Gs^Fp, Gs^Fp
Mm, Mm, Hh, Hh, Hh, Hh, Hh, Hh, Gg, Hh, Hh, Hh, Gg, Gg, Gg, Ch, Ch, Gg, Ww, Ww, Gg, Gg, Gg, Gs^Fp, Gg, Gg, Rr, Gg, Gg, Gg, Gg, Gg, Gg, Gg, Ch, Ch, Gg, Gg, Gg, Gg, Gg, Gg, Gg, Gg^Vh, Gs^Fp, Gs^Fp, Gs^Fp, Gs^Fp, Gs^Fp, Gs^Fp, Gs^Fp, Gs^Fp, Gs^Fp, Gs^Fp, Gs^Fp, Gs^Fp, Gs^Fp, Gs^Fp, Gs^Fp, Gs^Fp
Hh, Hh, Gg, Hh, Hh, Hh, Hh, Gg, Gg, Gg, Gg, Hh, Gg, Gg, Gg, Gg, Gg, Ch, Ww, Gg, Gg, Gg, Gg, Gg, Gg, Gs^Fp, Rr, Gg, Gg, Gg, Gg, Gg, Ch, Ch, Gg, Gg, Gg, Gg, Gg, Gg, Gg, Gs^Fp, Gs^Fp, Gg, Gg, Gs^Fp, Gs^Fp, Gs^Fp, Gs^Fp, Gs^Fp, Gs^Fp, Gs^Fp, Gs^Fp, Gs^Fp, Gs^Fp, Gs^Fp, Gs^Fp, Gs^Fp, Gs^Fp, Gs^Fp
Hh, Hh, Hh, Gg, Gg, Gg, Hh, Gg, Gg, Gg, Gg, Gg, Gg, Gg, Gg, Gg, Gg, Gg, Ww, Ch, Gg, Gg, Gg, Gg, Gg^Vh, Gg, Rr, Gg, Gg, Gg, Ch, Ch, Gg, Gg, Gg, Gg, Ww, Ww, Gg, Gg, Gg, Gg, Gg, Gg, Gs^Fp, Gg, Gs^Fp, Gs^Fp, Gs^Fp, Gs^Fp, Gs^Fp, Gs^Fp, Gs^Fp, Gs^Fp, Gs^Fp, Gs^Vl, Gs^Fp, Gs^Fp, Gs^Fp, Gs^Fp
Hh, Hh, Gg, Gg, Gg, Gg, Gg, Gg, Gg, Gg, Gg, Gg, Gg, Gg, Ww, Gg, Ww, Ww, Gg, Gg, Gg, Ch, Ch, Gg, Gg, Gg, Rr, Gg, Ch, Ch, Gg, Gg, Gg, Gg, Gg, Gg, Ww, Gg, Gs^Vh, Gg, Gg, Gg, Gs^Fp, Gg, Gg, Gg, Gs^Fp, Gs^Fp, Gs^Fp, Gs^Fp, Gs^Fp, Gs^Fp, Gs^Fp, Gs^Fp, Gs^Fp, Gs^Fp, Gs^Fp, Gs^Fp, Gs^Fp, Gs^Fp
Gg, Gg, Gg, Gg, Gg, Gg, Gg, Gg, Gg, Gg, Ww, Ww, Ww, Ww^Bw\, Gg, Ww, Gg, Ww, Gg, Gg, Gg, Gg, Gg, Ch, Ch, Gg, Ch, Rr, Rr, Gg, Gg, Gg, Gg, Gg, Ww, Ww, Gg, Gg, Gg, Gg, Gg, Gg, Gs^Fp, Gs^Fp, Gg, Gg, Gs^Fp, Gs^Fp, Gs^Fp, Gs^Fp, Gs^Fp, Gs^Fp, Gs^Fp, Gs^Fp, Gs^Fp, Gs^Fp, Gs^Fp, Gs^Fp, Gs^Fp, Gs^Fp
Gg, Gg, Gg, Gg, Gg, Gg, Gg, Gg, Ww, Ww, Gg, Gg, Gg, Gg, Gs^Fp, Gg, Gg, Ww, Gg, Gg, Gg, Gg, Gg, Gg, Gg, Ch, Gg, Gg, Rr, Gg, Ww, Ww, Ww, Ww, Gg, Gg, Gg, Gg, Gg, Gg, Gg, Gg, Gg, Gg, Gg, Gg, Gg, Gs^Fp, Gs^Fp, Gs^Fp, Gs^Fp, Gs^Fp, Gs^Fp, Gs^Fp, Gs^Fp, Gs^Fp, Gs^Fp, Gs^Fp, Gs^Fp, Gs^Fp
Gg, Gg, Gg, Gg, Gg, Gg, Ww, Gg, Ww, Ww, Gg, Gg, Gg, Gs^Fp, Gs^Fp, Gg, Ww, Ww, Ww, Re, Ww, Gg, Ww, Gg, Gg, Gg, Gg, Gg, Ww, Ww^Bw\, Rd, Gg, Gg, Gg, Gg, Gg, Gg, Gg, Gg, Gg, Gs^Vh, Gg, Gg, Gg, Gg, Gg, Gg, Gg, Gg, Gs^Fp, Gs^Fp, Gs^Fp, Gs^Fp, Gs^Fp, Gs^Fp, Gs^Fp, Gs^Fp, Gs^Fp, Gs^Fp, Gs^Fp
Gg, Gg, Ww, Gg, Ww, Ww, Gg, Ww, Gg, Gg, Gg, Gs^Fp, Gg, Gg, Gg, Gg, Ww, Gg, Gs^Fp, Ww, Gs^Fp, Ww, Gg, Ww, Ww, Gg, Gg, Ww, Ww, Gg, Gg, Rd, Rd, Gg, Gg, Gg, Gg, Gg, Gg, Gg, Gg, Gg, Gg, Gg, Gg, Gg, Gg, Gg, Gg, Gg, Gg, Gs^Fp, Gs^Fp, Gs^Fp, Gs^Fp, Gs^Fp, Gs^Fp, Gs^Fp, Gs^Fp, Gs^Fp
Ww, Ww, Ww, Ww, Ww, Ww, Gg, Gs^Vh, Gs^Fp, Gs^Fp, Gs^Fp, Gs^Fp, Gg, Gg, Gg, Ww, Gg, Gg, Gs^Fp, Re, Gs^Fp, Gs^Fp, Gg, Gg, Gg, Ww, Ww, Ww, Gg, Gg, Gg, Gg, Gg, Rd, Re, Gg, Gg, Gg, Gg, Gg, Gg, Gg, Gg, Gg, Gg, Gg, Gg, Gg, Gg, Gg, Gg, Gs^Fp, Gs^Fp, Gs^Fp, Gs^Fp, Gs^Fp, Gs^Fp, Gs^Fp, Gs^Fp, Gs^Fp
Gg, Gg, Gg, Gg, Gg, Gg, Gg, Gg, Gg, Gs^Fp, Gg, Gg, Gg, Gs^Fp, Gg, Ww, Ww, Gg, Re, Re, Gg, Gs^Fp, Gg, Gg, Gg, Gg, Gg, Gg, Gg, Gg, Gg, Gg, Gg, Gg, Gg, Re, Re, Gg, Gg, Gg, Gg, Gg, Gg, Gg, Gg, Gg, Gg, Gg, Gg, Gg, Gg, Gg, Gg, Gs^Fp, Gs^Fp, Gs^Fp, Gs^Fp, Gs^Fp, Gs^Fp, Gs^Fp
Gg, Gg, Gg, Gg, Gg, Gg, Gg, Gg, Gg, Gg, Gg, Hh, Gg, Gs^Fp, Gg, Gg, Ww, Gg, Gg, Hh, Gg, Gg, Gg, Gg, Gg, Gg, Gg, Gg, Gg, Gs^Vh, Gg, Gg, Gg, Gg, Gg, Gg, Gg, Re, Re, Gg, Gg, Gg, Gg, Gg, Gg, Gg, Gg, Gg, Gg, Gg, Gg, Gg, Gg, Gg, Gg, Gs^Fp, Gs^Fp, Gs^Fp, Gs^Fp, Gs^Fp
Gg, Gg, Gg, Gg, Gg, Gg, Gg, Gg, Hh, Gg, Hh, Hh, Gg, Gg, Ww, Ww, Gg, Ww, Hh, Hh, Hh, Hh, Gg, Gg, Gg, Gg, Hh, Gg, Gg, Gg, Gg, Gg, Gg, Gg, Gg, Gg, Gg, Gg, Gg, Re, Re, Gg, Gg, Gg, Gg, Gg, Gg, Gg, Gg, Gs^Vh, Gg, Gg, Gg, Gg, Gg, Gs^Fp, Gs^Fp, Gs^Fp, Gs^Fp, Gs^Fp
Gg, Gg, Gg, Gg, Gg, Gg, Gg, Gg, Gg, Hh, Mm, Hh, Hh, Gg, Ww, Ww, Ww, Ww, Hh, Mm, Hh, Gg, Gg, Gg, Re, Gg, Hh, Gg, Gg, Gg, Gg, Gg, Gg, Gg, Gg, Gg, Gg, Gg, Gg, Gg, Gg, Re, Re, Gg, Gg, Gg, Gg, Gg, Gg, Gg, Gg, Gg, Gg, Gg, Gg, Gs^Fp, Gs^Fp, Gs^Fp, Gs^Fp, Gs^Fp
Gg, Gg, Gg, Gg, Gg, Gg, Gg, Gg, Hh, Hh, Hh, Mm, Hh, Gg, Ww, Ww^Vm, Ww, Gg, Hh, Mm, Mm, Hh, Gg, Gg, Re, Hh, Mm, Hh, Gg, Gg, Gg, Gg, Hh, Gg, Gg, Gs^Vh, Gg, Gg, Gg, Gg, Gg, Gg, Gg, Re, Re, Gg, Gg, Gg, Gg, Gg, Gg, Gg, Gg, Gg, Gg, Gg, Gg, Gs^Fp, Gg, Gg
Gg, Gg, Gg, Gg, Hh, Gg, Gs^Vh, Gg, Hh, Mm, Mm, Mm, Mm, Ww, Wo, Wo, Wo, Ww, Mm, Mm, Mm, Hh, Hh, Hh, Re, Hh, Mm, Hh, Hh, Gg, Gg, Gg, Gg, Hh, Gg, Gg, Gg, Gg, Gg, Gg, Gg, Gg, Gg, Gg, Gg, Re, Re, Gg, Gg, Gg, Gg, Gg, Gg, Gg, Gg, Gg, Gg, Gg, Gg, Gg
Gg, Gg, Gg, Gg, Hh, Hh, Hh, Hh, Hh, Hh, Mm, Mm, Ww, Ww, Wo, Wo, Wo, Ww, Ww, Mm, Mm, Mm, Mm, Hh, Re, Mm, Mm, Mm, Hh, Gg, Gg, Gg, Hh, Hh, Hh, Gg, Gg, Gg, Gg, Gg, Gg, Gg, Gg, Gg, Gg, Gg, Gg, Re, Re, Gg, Gg, Gg, Co, Gg, Co, Gg, Gg, Gg, Gg, Gg
Hh, Hh, Hh, Gg, Gg, Gg, Hh, Mm, Mm, Mm, Mm, Mm, Ww, Wo, Wo, Ww^Vm, Wo, Wo, Ww, Mm, Mm, Gg^Vh, Re, Re, Ch, Mm, Mm, Mm, Mm, Hh, Hh, Hh, Mm, Mm, Hh, Gg, Gg, Gg, Gg, Gg, Gg, Gg, Gg, Gg, Gg, Gg, Gg, Gg, Gg, Re, Co, Co, Co, Co, Co, Co, Gg, Gg, Gg, Gg
Mm, Mm, Mm, Hh, Gg, Gg, Hh, Hh, Mm, Mm, Mm, Ww, Ww, Wo, Ww, Wo, Ww, Ww, Ww, Ww, Re, Mm, Re, Ch, 3 Kh, Ch, Re, Mm, Mm, Mm, Mm, Mm, Mm, Hh, Gg, Gg, Hh, Hh, Hh, Gg, Gg, Gg, Gg, Gg, Gg, Gg, Gg, Gg, Gg, Gg, Co, Co, Ko, 1 Ko, Co, Co, Gg, Gg, Gg, Gg
Mm, Mm, Mm, Hh, Hh, Hh, Mm, Mm, Mm, Mm, Mm, Mm, Mm, Ww, Mm, Ww, Mm, Mm, Mm, Mm, Mm, Re, Mm, Ch, Ch, Ch, Mm, Re, Re, Mm, Gg^Vh, Mm, Mm, Hh, Hh, Gg, Hh, Mm, Hh, Gg, Hh, Hh, Gg, Gg, Gg, Gs^Vh, Gg, Gg, Gg, Gg, Co, Co, Co, Co, Co, Co, Gg, Gg, Gg, Gg
Mm, Mm, Mm, Mm, Mm, Hh, Mm, Mm, Mm, Mm, Mm, Mm, Mm, Mm, Mm, Mm, Mm, Mm, Mm, Mm, Mm, Gg^Vh, Mm, Mm, Mm, Mm, Mm, Gg^Vh, Mm, Re, Mm, Mm, Mm, Mm, Mm, Hh, Mm, Mm, Mm, Hh, Hh, Gg, Gg, Gg, Gg, Gg, Gg, Gg, Gg, Gg, Gg, Co, Co, Co, Gg, Re, Re, Gg, Gg, Gg
Mm, Mm, Mm, Mm, Mm, Mm, Mm, Mm, Mm, Mm, Mm, Mm, Mm, Mm, Mm, Mm, Mm, Mm, Mm, Mm, Mm, Mm, Mm, Mm, Mm, Mm, Mm, Mm, Mm, Mm, Mm, Mm, Mm, Mm, Mm, Mm, Mm, Mm, Mm, Mm, Hh, Gg, Hh, Gg, Gg, Gg, Gg, Gg, Gg, Gg, Gg, Gg, Gg, Gg, Gg, Gg, Gg, Re, Re, Gg
Mm, Mm, Mm, Mm, Mm, Mm, Mm, Mm, Mm, Mm, Mm, Mm, Mm, Mm, Mm, Mm, Mm, Mm, Mm, Mm, Mm, Mm, Mm, Mm, Mm, Mm, Mm, Mm, Mm, Mm, Mm, Mm, Mm, Mm, Mm, Mm, Mm, Mm, Mm, Mm, Hh, Gg, Hh, Gg, Gg, Gg, Gg, Gg, Gg, Gg, Gg, Gg, Gg, Gg, Gg, Gg, Gg, Gg, Gg, Re
