border_size=1
usage=map

Ss, Gs^Fp, Gg, Gg, Gg, Gg, Gg, Gg, Hh, Hh, Hh, Mm, Mm, Mm, Mm, Hh, Mm, Gll^Fp, Gll^Fp, Rr, Gg, Gg
Ds, Gs^Fp, Ds, Gg, Gg, Gg, Gg, Gg, Gg, Hh, Hh, Hh, Mm, Mm, Mm, Mm, Mm, Gg, Rr, Rr, Gg, Gll^Fp
Ds, Gg, Gg, Gg, Gg, Gg, Gs^Fp, Gg, Gg, Gg, Hh, Hh, Mm, Mm, Mm, Mm, Hh, Gg^Vh, Rr, Gg, Gg, Gll^Fp
Gg, Gg, Gg, Gg, Gg, Gg, Gg, Gs^Fp, Hh, Hh, Mm, Mm, Mm, Mm, Mm, Ch, Ch, Ch, Gg, Gg, Gll^Fp, Gll^Fp
Gg, Gg, Gg, Gg, Gg, Gg, Gg, Gg, Hh, Hh, Mm, Mm, Mm, Mm, Mm, Ch, 2 Kh, Ch, Gg, Gg, Gll^Fp, Gll^Fp
Gg, Gg, Gg, Gg, Gg, Gg, Gg, Gs^Fp, Hh, Hh, Mm, Mm, Mm, Mm, Hh, Hh, Rr, Gs^Fp, Gg, Ds, Gs^Fp, Gs^Fp
Gg, Gg, Gg, Gg, Gg, Gg, Hh, Hh, Hh, Hh, Mm, Mm, Mm, Mm, Hh, Gs^Fp, Rr, Gs^Fp, Gs^Fp, Ds, Gs^Fp, Gs^Fp
Gg, Gg, Gg, Gg, Gg, Gs^Fp, Gg^Ve, Gs^Fp, Hh, Hh, Mm, Mm, Mm, Hh, Hh, Gs^Fp, Rr, Gs^Fp, Gs^Fp, Ds, Ds, Gs^Fp
Gg, Gg, Gg, Gs^Fp, Gs^Fp, Gs^Fp, Gg, Gg, Gg, Gs^Fp, Hh, Hh, Hh, Hh, Gg, Gs^Fp, Rr, Gs^Fp, Gs^Fp, Ss, Ss, Gs^Fp
Ww, Gg^Vh, Gs^Fp, Gs^Fp, Gs^Fp, Ss, Ss, Gs^Fp, Gg, Gg, Gs^Fp, Gg^Vh, Gg, Gs^Fp, Gg, Gg, Rr, Gs^Fp, Gg^Ve, Gs^Fp, Gs^Fp, Gs^Fp
Ww, Ww, Ww, Ww, Ds, Gs^Fp, Gs^Fp, Ss, Gs^Fp, Gs^Fp, Gs^Fp, Gg, Gg, Gg, Gg, Rr, Gs^Fp, Gs^Fp, Gs^Fp, Gs^Fp, Gs^Fp, Gg
Ww, Gg, Ds, Wo, Wo, Ds, Ds, Ds, Gg, Gg, Gg, Gg, Gg, Gg, Rr, Rr, Gg, Gg, Gs^Fp, Gs^Fp, Gs^Fp, Gg
Ww, Gg, Ds, Ds, Ds, Ds, Ds, Ds, Gg, Gg, Gg, Gg, Rr, Rr, Gg, Gg, Gg, Gg, Gg, Gs^Fp, Gs^Fp, Gs^Fp
Rr, Gg, Ss, Ds, Gs^Fp, Gs^Fp, Gg, Gg, Gg, Gg, Gg, Gg^Vh, Rr, Gg, Gg, Gg, Gg, Gg, Gg, Gg, Gg, Gs^Fp
Rr, Gs^Fp, Ss, Gs^Fp, Gg^Ve, Gg, Gg, Gg, Gg, Gg, Rr, Rr, Gg, Gg, Gg, Gg, Gg, Gg, Gg, Gg, Gg, Gg
Rr, Gs^Fp, Gg^Ve, Gs^Fp, Gs^Fp, Gg, Gg, Gg, Ce, Ce, Ce, Gg, Gg, Gg, Rr, Rr, Rr, Rr, Rr, Gg, Gg, Gg
Gs^Fp, Rr, Gs^Fp, Gs^Fp, Hh, Hh, Hh, Gg, Ce, 1 Ke, Ce, Gg, Gg, Gg, Rr, Hh, Gg^Vh, Hh, Gg, Rr, Rr, Hh
Hh, Rr, Gg, Hh, Hh, Hh, Hh, Hh, Rr, Rr, Gg, Gg, Gg, Rr, Hh, Hh, Mm, Mm, Mm, Hh, Hh, Rr
Mm, Rr, Rr, Hh, Hh, Hh, Hh, Rr, Gg, Gg, Gg, Gg, Gg, Rr, Hh, Hh, Mm, Mm, Mm, Mm, Mm, Rr
Hh, Hh, Gg, Rr, Rr, Gs^Fp, Rr, Rr, Gg, Gg, Gg, Gg, Gg, Rr, Rr, Hh, Mm, Mm, Mm, Mm, Mm, Mm
Mm, Hh, Gg, Gg^Vh, Rr, Rr, Gg, Gs^Fp, Gg, Gg, Gg, Gg, Gs^Fp, Gs^Fp, Rr, Gg, Mm, Mm, Mm, Mm, Mm, Mm
Hh, Hh, Gg, Gg, Gg, Rr, Rr, Gg, Rr, Rr, Rr, Gg, Gg, Gs^Fp, Rr, Hh, Mm, Mm, Mm, Mm, Mm, Mm
