border_size=1
usage=map

Xue, Xue, Xue, Xue, Xue, Xue, Ur, Uu, Xue, Xue, Xue, Xue, Xue, Uu
Xue, Xue, Xue, Xue, Xue, Xue, Co, Ur, Xue, Xue, Xue, Xue, Uu, Xue
Xue, Uu, Uu, Uu, Uu, Co, 2 Ko, Co, Uu, Xue, Uu, Uu, Uu, Xue
Xue, Uu, Uu^Vu, Uu, Uu, Co, Co, Co, Uu, Uu, Uu, Uu^Vu, Uu, Xue
Xue, Uu, Uu, Uu, Uu, Uu, Ur, Ur, Uu, Uu, Uu, Uu, Uu, Xue
Xue, Uu, Uu, Uu, Uu, Uu, Ur, Ur, Uu, Uu, Uu, Uu, Uu, Xue
Xue, Uu, Uu^Vu, Uu, Uu, Uu, Ur^Ii, Ur, Uu, Uu, Uu, Uu, Uu, Xue
Xue, Uu, Uu, Uu, Uu, Uu, Ur^Ii, Ur^Ii, Uu, Uu, Uu, Uu^Vud, Uu, Xue
Xue, Uu, Uu, Uu, Uu, Uu, Ur, Ur^Ii, Uu, Uu, Uu, Uu, Uu, Xue
Xue, Uu, Uu, Uu, Uu, Uu, Ur, Ur, Uu, Uu, Uu, Uu, Uu, Xue
Xue, Uu, Uu^Vud, Uu, Uu, Uu, Cud, Ur, Uu, Uu, Uu^Vud, Uu, Uu, Xue
Xue, Uu, Uu, Uu, Uu, Cud, 1 Kud, Cud, Uu, Uu, Uu, Uu, Uu, Xue
Xue, Xue, Xue, Xue, Xue, Cud, Cud, Cud, Xue, Xue, Xue, Xue, Xue, Xue
Xue, Xue, Xue, Xue, Xue, Uu, Ur, Ur, Xue, Xue, Xue, Xue, Xue, Xue
