|00000000000000000000000000000000
|00000000000000001100000000000000
|00000000000000011100000000000000
|00000000000000011110000000000000
|00000000000000011110000000000000
|00000000000000010111000000000000
|00000000000000000010000000000000
|00000110110000000000000000000000
|00001100110000000000000000000000
|00000010100000000000000000000000
|00010011001000000000000000000000
|00011111111100000000000000000000
|00010011001000000000000000000000
|00000010100000000000000000000000
|00001100110000000000000000000000
|00000110110000000000000000000000
|00000000000000000000000000000000
|00000000000000000000000000000000
|00000000000000000000000000000000
|00000000000000000000000000000000
|00000000000000000000000000000000
|00000000000000000000000000000000
|00000000000000000000000000000000
|00000000000000000000000000000000
|00000000000000000000000000000000
|00000000000000000000000000000000
|00000000000000000000000000000000
|00000000000000000000000000000000
|00000000000000000000000000000000
|00000000000000000000000000000000
|00000000000000000000000000000000
|00000000000000000000000000000000
|00000000000000000000000000000000
|00000000000000000000000000000000
|00000000000000000000000000000000
|00000000000000000000000000000000
|00000000000000000000000000000000
|00000000000000000000000000000000
|00000000000000000000000000000000
|00000000000000000000000000000000
|00000000000000000000000000000000
|00000000000000000000000000000000
