border_size=1
usage=map

Xu, Xu, Xu, Xu, Xu, Xu, Xu, Xu, Xu, Xu, Ur, Ur, Uu, Xu, Xu, Xu, Xu, Xu, Xu, Xu, Xu, Xu
Xu, Xu, Uh, Xu, Uh, Xu, Uh, Xu, Uh, Uu, Uu, Ur, Uu, Xu, Uh, Xu, Ur, Xu, Uh, Xu, Uh, Xu
Xu, Uh, Uh, Uh, Ur, Ur, Ur, Uh, Uh, Uh, Uue, Ur, Uue, Uh, Ur, Ur, Co, Ur, Ur, Uh, Uh, Xu
Xu, Uh, Uh, Ur, Co, Co, Co, Ur, Uue^Edt, Uue^Edt, Qxe, Ur, Qxe, Uue, Uue^Edb, Co, 3 Ko, Co, Uh, Ur, Ur, Xu
Xu, Uh, Uh, Ur, Co, 2 Ko, Co, Uue^Edb, Qxe, Qxe, Qxe, Qxu^Bcx|, Qxe, Qxe, Qxe, Co, Co, Co, Uh, Uh^Edt, Ur, Xu
Xu, Uh, Ur, Ur, Uu, Co, Uue^Edt, Uue, Qxe, Qxe, Xos, Qxu^Bcx|, Xos, Qxe, Qxe, Uue, Uue^Edt, Uh, Uu^Vu, Uh^Edt, Ur, Xu
Xu, Uh, Ur, Uu^Vu, Uue^Edt, Uue^Edt, Uue, Uue, Xos, Xos, Xos, Qxu^Bcx|, Xos, Xos, Xos, Uue, Uue^Edb, Uue^Edt, Uue^Edb, Uh, Ur, Xu
Xu, Ur, Uue^Edt, Uue^Edt, Uue^Edt, Uue, Xos, Xos, Wo, Wo, Xos, Ww, Xos, Wo, Wo, Xos, Xos, Uue^Edt, Uue^Edt, Uue^Edb, Ur, Xu
Xu, Ur, Uue, Uue, Xos, Xos, Wo, Wo, Wo, Wo, Xos, Ww, Xos, Wo, Wo, Wo, Wo, Xos, Xos, Uue, Ur, Xu
Xu, Ur, Uue, Xos, Ww, Xos, Xos, Wo, Wo, Wo, Xos, Ww, Xos, Wo, Wo, Wo, Xos, Xos, Xos, Uue, Ur, Xu
Xu, Ur, Uue, Xos, Xos, Ww, Ww, Xos, Xos, Wo, Xos, Ww, Xos, Wo, Xos, Xos, Ww, Ww, Xos, Uue, Ur, Xu
Xu, Ur, Uue, Xos, Wo, Xos, Xos, Ww, Ww, Xos, Ww, Ww, Ww, Xos, Ww, Ww, Xos, Xos, Xos, Uue, Ur, Xu
Xu, Ur, Uue, Xos, Wo, Wo, Wo, Xos, Xos, Ww, Ww, Ww, Ww, Ww, Xos, Xos, Wo, Wo, Xos, Uue, Ur, Xu
Xu, Ur, Uue, Xos, Wo, Wo, Wo, Wo, Xos, Ww, Ww, Ww, Ww, Ww, Xos, Wo, Wo, Wo, Xos, Uue, Ur, Xu
Xu, Ur, Uue, Xos, Wo, Wo, Xos, Xos, Ww, Ww, Ww, Ww, Ww, Ww, Ww, Xos, Xos, Wo, Xos, Uue, Ur, Xu
Xu, Ur, Uue, Xos, Xos, Xos, Ww, Ww, Xos, Xos, Xos, Ww, Xos, Xos, Xos, Ww, Ww, Xos, Xos, Uue, Ur, Xu
Xu, Ur, Uue, Xos, Ww, Ww, Xos, Xos, Wo, Wo, Xos, Ww, Xos, Wo, Wo, Xos, Xos, Ww, Xos, Uue, Ur, Xu
Xu, Ur, Qxe, Xos, Xos, Xos, Wo, Wo, Wo, Wo, Xos, Ww, Xos, Wo, Wo, Wo, Wo, Xos, Xos, Uue, Ur, Xu
Xu, Ur, Uue, Qxe, Qxe, Xos, Xos, Wo, Wo, Wo, Xos, Ww, Xos, Wo, Wo, Wo, Xos, Xos, Qxe, Qxe, Ur, Xu
Xu, Ur, Ur, Uue, Uue, Qxe, Qxe, Xos, Xos, Wo, Xos, Ww, Xos, Wo, Xos, Xos, Qxe, Qxe, Uue, Uue, Ur, Xu
Xu, Xu, Xu, Ur, Ur, Uue, Uue, Qxe, Qxe, Xos, Xos, Ww, Xos, Xos, Qxe, Qxe, Uue, Uue, Uue, Ur, Uue, Xu
Xu, Xu, Xu, Uue, Ur, Uue, Uue, Uue, Uue, Qxe, Qxe, Qxu^Bcx|, Qxe, Qxe, Uue, Uue, Uue, Uue, Ur, Ur, Xu, Xu
Xu, Xu, Xu, Xu, Xu, Ur, Uue, Uue, Uue, Uue, Qxe, Qxu^Bcx|, Qxe, Uue, Uue, Uue, Uue, Uue, Ur, Uue, Xu, Xu
Xu, Xu, Xu, Uu^Vud, Xu, Ur, Ur, Uue, Uue, Uue, Qxe, Qxu^Bcx|, Qxe, Uue, Uue, Uue, Uue, Uue, Ur, Uue, Xu, Xu
Xu, Xu, Xu, Uu, Uu, Ur, Xu, Xu, Uu, Uue, Qxu, Qxu^Bcx|, Qxu, Uu, Uu^Vu, Uue, Ur, Ur, Uu, Xu, Xu, Xu
Xu, Xu, Xu, Xu, Xu, Ur, Xu, Xu, Uu, Qxu, Qxu, Qxu^Bcx|, Qxu, Uu, Uu, Uu, Ur, Uu, Xu, Xu, Xu, Xu
Xu, Xu, Xu, Xu, Xu, Ur, Ur, Uu, Qxu, Qxu, Qxu, Qxu^Bcx|, Qxu, Qxu, Uu, Uu, Ur, Uu, Xu, Xu, Xu, Xu
Xu, Xu, Xu, Xu, Xu, Xu, Ur, Uu, Qxu, Qxu, Qxu, Qxu^Bcx|, Qxu, Qxu, Qxu, Ur, Uu, Xu, Xu, Xu, Xu, Xu
Xu, Xu, Xu, Xu, Xu, Xu, Uu, Ur, Uu^Edt, Qxu, Qxu, Qxu^Bcx|, Qxu, Qxu, Uu, Ur, Uu, Xu, Xu, Xu, Xu, Xu
Xu, Xu, Xu, Xu, Uu, Uu, Uh, Ur^Edt, Ur, Qxu, Qxu, Qxu^Bcx|, Qxu, Qxu, Ur, Ur, Uu, Xu, Xu, Xu, Xu, Xu
Xu, Xu, Xu, Xu, Uu, Uh, Uu, Uu, Uu, Qxu, Qxu, Qxu^Bcx|, Qxu, Qxu, Qxu, Uu, Uu, Xu, Xu, Xu, Xu, Xu
Xu, Xu, Xu, Xu, Uu, Uu^Vud, Uh, Uu, Qxu, Qxu, Qxu, Qxu^Bcx|, Qxu, Qxu, Qxu, Uu, Uu, Uh, Uu, Uh, Xu, Xu
Xu, Xu, Xu, Xu, Uu, Uh, Uh, Uu, Qxu, Qxu, Qxu, Qxu^Bcx|, Qxu, Qxu, Qxu, Uu, Uu, Uu^Vud, Uu, Uh, Xu, Xu
Xu, Xu, Xu, Xu, Uu, Uh, Uh, Uu, Qxu, Qxu, Qxu, Qxu^Bcx|, Qxu, Qxu, Qxu, Qxu, Uu, Uh, Uh, Uh, Xu, Xu
Xu, Xu, Xu, Xu, Xu, Uu, Uh, Uu, Qxu, Qxu, Qxu, Qxu^Bcx|, Qxu, Qxu, Qxu, Qxu, Uu, Uh, Uu, Uh, Xu, Xu
Xu, Xu, Xu, Xu, Xu, Uu, Uu, Uu, Qxu, Qxu, Qxu, Qxu^Bcx|, Qxu, Qxu, Qxu, Qxu, Uu, Uh, Uu, Uh, Xu, Xu
Xu, Xu, Xu, Xu, Xu, Xu, Uu, Uu, Qxu, Qxu, Qxu, Qxu^Bcx|, Qxu, Qxu, Qxu, Qxu, Uu, Uh, Uh, Uh, Xu, Xu
Xu, Xu, Xu, Xu, Uu, Uu, Uu^Edt, Uu, Qxu, Qxu, Qxu, Qxu^Bcx|, Qxu, Qxu, Qxu, Qxu, Uu, Uu, Uh, Uh, Xu, Xu
Xu, Xu, Uu, Xu, Uu^Vud, Uu, Uu^Edt, Uu, Ur, Qxu, Ur, Ur, Ur, Uu, Uu, Uu, Uu, Uu, Uh, Xu, Xu, Xu
Xu, Xu, Uu, Uu, Uu^Edt, Uu, Uu^Edt, Ur, Ur, Ur, Ce, Ce, 1 Ke, Ce, Ce, Uu, Uu, Uu^Vud, Uh, Xu, Xu, Xu
Xu, Xu, Xu, Uu, Xu, Uu, Ur, Ur, Uu, Uu, Uu, Ce, Uu, Ce, Uu, Uu, Xu, Uu, Xu, Xu, Xu, Xu
Xu, Xu, Xu, Xu, Xu, Ur, Ur, Uu, Uu, Uu, Uu, Uu, Uu, Uu, Uu, Uu, Xu, Xu, Xu, Xu, Xu, Xu
