border_size=1
usage=map

Gg, Gg, Mm, Gg, Mm, Gg, Mm, Gg, Mm, Gg, Mm, Mm, Mm, Mm, Mm, Mm, Rr, Hh, Hh, Hh, Hh, Hh, Hh, Hh, Hh, Hh, Hh, Hh, Hh, Mm, Mm, Mm, Mm, Mm, Mm, Mm, Mm, Mm, Mm, Mm, Mm, Mm, Mm, Mm, Mm, Mm, Mm, Mm, Mm, Mm, Mm, Mm, Mm, Gg, Mm, Gg, Mm, Gg, Mm, Mm, Mm, Gg
Mm, Mm, Mm, Mm, Mm, Mm, Mm, Mm, Mm, Mm, Mm, Mm, Mm, Mm, Mm, Hh, Rr, Hh, Hh, Hh, Hh, Hh, Hh, Rr^Vhc, Hh, Hh, Hh, Hh, Hh, Hh, Hh, Mm, Mm, Mm, Mm, Mm, Mm, Mm, Mm, Mm, Mm, Mm, Mm, Mm, Mm, Mm, Mm, Mm, Mm, Mm, Mm, Mm, Mm, Mm, Mm, Mm, Mm, Mm, Mm, Mm, Mm, Mm
Mm, Mm, Mm, Mm, Mm, Mm, Mm, Mm, Mm, Mm, Mm, Mm, Hh, Hh, Hh, Hh, Rr^Vhc, Rr, Rr, Hh, Hh, Hh, Hh, Hh, Hh, Hh, Hh, Hh, Hh, Hh, Hh, Mm, Mm, Mm, Mm, Mm, Rr^Vhc, Mm, Mm, Mm, Co, 5 Ko, Mm, Mm, Mm, Mm, Mm, Mm, Mm, Mm, Mm, Mm, Gg, Gg, 2 Ko, Mm, Gg, Mm, Gg, Mm, Mm, Mm
Hh, Mm, Mm, Mm, Mm, Mm, Mm, Mm, Mm, Mm, Mm, Hh, Hh, Hh, Ch, Ch, Ch, Hh, Rr^Vhc, Rr, Rr, Hh, Hh, Hh, Hh, Hh, Hh, Hh, Hh, Hh, Hh, Mm, Mm, Mm, Mm, Mm, Mm, Mm, Mm, Co, Co, Co, Mm, Mm, Mm, Mm, Mm, Mm, Mm, Mm, Mm, Mm, Gg, Co, Co, Co, Gg, Gs, Gg, Mm, Mm, Mm
Gll^Fp, Hh, Hh, Hh, Hh, Mm, Mm, Mm, Mm, Mm, Mm, Mm, Mm, Hh, Ch, 1 Kh, Rr, Rr, Rr, Hh, Hh, Rr, Hh, Gs^Fp, Gg, Hh, Gg, Hh, Hh, Hh, Hh, Mm^Edt, Mm, Mm, Mm, Mm, Mm, Mm, Mm, Mm, Mm, Mm, Mm, Mm, Mm, Mm, Mm, Mm, Mm, Mm, Rr, Rr, Rr, Rr, Rr, Rr, Rr, Gg, Gs^Vh, Gg, Mm, Mm
Gll^Fp, Gll^Fp, Gll^Fp, Gll^Fp, Gll^Fp, Hh, Hh, Mm, Hh, Mm, Mm, Mm, Rr, Rr, Hh, Ch, Hh, Hh, Hh, Rr, Rr, Rr, Rr, Gg, Gs^Fp, Gs^Fp, Hh, Hh, Hh, Rr^Vhc, Hh, Mm^Edt, Mm^Edt, Mm, Mm, Mm, Mm, Mm, Mm, Mm, Mm, Mm, Mm, Mm, Mm, Mm, Mm, Mm, Mm, Mm, Rr, Mm, Gll^Fp, Gs, Gs, Gll^Fp, Gll^Fp, Rr, Rr, Gs, Gs, Mm
Gg, Gll^Fp, Gg, Gll^Fp, Gll^Fp, Gll^Fp, Gll^Fp, Hh, Gll^Fp, Hh, Mm, Rr, Mm, Mm, Mm, Hh, Hh, Hh, Hh, Hh, Rr, Gg, Hh, Rr, Rr, Hh, Hh, Hh, Hh, Hh, Hh, Hh, Mm^Edt, Mm, Mm, Mm, Mm, Mm, Mm, Mm, Mm, Mm, Mm, Mm, Mm, Mm, Mm, Mm, Mm, Rr, Rr^Vhc, Mm, Gll^Fp, Gll^Fp, Gll^Fp, Gs, Gd, Gll^Fp, Gll^Fp, Rr, Rr, Gg
Gg, Gll^Fp, Gll^Fp, Gll^Fp, Gll^Fp, Gll^Fp, Gll^Fp, Gll^Fp, Gll^Fp, Hh, Rr, Rr, Mm, Mm, Mm, Rr^Vhc, Hh^Edb, Hh, Hh, Rr^Vhc, Rr, Hh, Hh, Hh, Rr, Hh, Hh, Hh, Hh, Hh, Hh, Hh, Mm^Edt, Mm, Mm, Mm, Mm, Mm, Mm, Mm, Mm, Mm, Mm, Mm, Mm, Mm, Rr^Vhc, Mm, Rr, Rr, Hh, Hh, Gll^Fp, Gll^Fp, Gd, Gs, Gd, Gll^Fp, Gll^Fp, Gll^Fp, Rr, Gg
Gg, Gg, Gll^Fp, Gg, Gll^Fp, Gll^Fp, Gll^Fp, Gll^Fp, Rr, Rr, Mm, Mm, Mm, Mm, Mm, Hh, Hh, Hh, Hh, Hh, Rr, Hh, Hh, Hh, Hh, Rr, Rr, Hh, Hh, Hh, Hh, Hh, Hh, Mm, Mm, Mm, Mm, Mm, Mm, Mm, Mm, Mm, Mm, Mm, Mm, Mm, Mm, Rr, Hh, Hh, Hh, Hh, Gll^Fp, Gll^Fp, Gs, Gs, Gs, Gd, Gll^Fp, Rr, Rr, Gg
Gg, Gll^Fp, Gg, Gll^Fp, Gg, Gg, Rr, Rr, Gll^Fp, Hh, Mm, Mm, Mm, Mm, Mm, Mm, Hh, Hh, Hh, Hh, Rr, Hh, Hh, Hh, Hh, Rr^Vhc, Rr, Hh, Hh, Hh, Hh, Hh, Hh, Hh, Mm, Mm, Mm, Mm, Mm, Mm, Mm, Mm, Mm, Mm, Mm, Mm, Rr, Rr, Hh, Hh, Hh, Hh, Gd, Gd, Gd, Gd, Gd, Gs, Gs^Vh, Rr, Ss, Gg
Gg, Gg, Rr, Gs^Vl, Rr, Rr, Gg, Gg, Gll^Fp, Hh, Mm, Mm, Mm, Mm, Mm, Mm, Hh, Hh, Hh, Hh, Hh, Rr, Rr, Hh, Hh, Hh, Rr, Hh, Hh, Hh, Hh, Hh, Hh, Hh, Hh, Hh, Mm, Mm, Mm, Mm, Hh, Hh, Hh, Hh, Hh, Rr, Hh, Hh, Hh, Hh, Hh, Hh, Gll^Fp, Gll^Fp, Gll^Fp, Gll^Fp, Gll^Fp, Gll^Fp, Rr, Rr, Ss, Gg
Rr, Rr, Gg, Rr, Rr, Gg, Gll^Fp, Gll^Fp, Gll^Fp, Hh, Mm, Mm, Mm, Mm, Mm, Hh, Hh, Hh, Hh, Hh, Hh, Hh, Hh, Rr, Rr, Hh, Rr, Hh, Hh, Hh, Hh, Hh, Hh, Hh, Hh, Hh, Hh, Hh, Hh, Hh, Hh, Hh, Hh, Hh, Hh, Rr, Hh, Hh, Hh, Gll^Fp, Gll^Fp, Gll^Fp, Gll^Fp, Gll^Fp, Gll^Fp, Gll^Fp, Rr, Rr, Ss, Ss, Ss^Vhs, Ss
Gll^Fp, Gll^Fp, Gll^Fp, Gll^Fp, Rr, Gll^Fp, Gg, Gg, Gll^Fp, Hh, Mm, Mm, Mm, Mm, Mm, Hh, Hh, Hh, Hh, Hh, Hh, Hh, Hh, Hh, Rr, Ch, Ch, Ch, Ch, Ch, Ch, Ch, Ch, Ch, Ch, Hh, Ch, Hh, Hh, Hh, Hh, Hh, Hh, Gg, Rr, Rr, Rb, Rr^Vhc, Rr, Gll^Fp, Rr, Gll^Fp, Rr, Gll^Fp, Rr, Rr, Ss, Ss, Ss, Ss, Ss, Gg
Gg, Gg, Gg, Gg, Rr, Gg, Gg, Gg, Gll^Fp, Hh, Mm, Mm, Ww, Mm, Ww, Hh, Hh, Hh, Hh, Hh, Hh, Hh, Hh, Hh, Rr, Ch, Ch, Ch, Rr^Vhc, Ch, Rr, Kh, Rr, Ch, Rr^Vhc, Ch, Ch, Hh, Rr, Rr, Rr, Rr, Rr, Rr, Gg, Hh, Hh, Rb, Co, Rr, Gs^Fp, Rr, Gg, Rr, Rr, Ss, Ss^Vhs, Ss, Ss, Ss, Ss, Gg
Ww, Ww, Ww, Rr, Gg, Gg, Gg, Gg, Gll^Fp, Hh, Ww, Mm, Ww, Ww, Ww, Ww, Hh, Hh, Hh, Hh, Hh, Hh, Hh, Hh, Gg, Ch, Ch, Rr, Rr, Rr, Rr, Rr, Rr, Rr, Rr, Ch, Ch, Rr, Gg, Gg, Gg, Rr^Vhc, Gg, Gg, Gg, Gg, Gg, Co, 3 Ko, Co, Gg, Gs^Fp, Gs, Rb, Rr, Ss, Ss, Ss, Ss, Ss, Ss, Gg
Ww, Ww, Ww^Vm, Ww, Ww, Ww, Ww, Gg, Gg, Ww, Ww, Ww, Ww, Ww, Ww, Ww, Ww, Hh, Ww, Ww, Ww, Gg, Gg, Gg, Gg, Ch, Ch, Rr, Rr, Rr, Rr, Rr, Rr, Rr, Rr, Ch, Ch, Gg, Gg, Gg, Gg, Gg, Gg, Gs^Fp, Gg, Gg, Gg, Co, Co, Co, Gg, Gs, Rb, Rb, Sm, Rr, Sm, Ss, Sm, Ss, Ss, Ss
Ww, Ww, Ww, Ww, Ww, Ww, Ww, Ww, Ww, Ww, Ww, Ww^Vm, Ww, Ww, Ww, Ww, Ww, Ww, Ww, Rr^Vhc, Gg, Ww, Ww, Ww, Gg, Ch, Ch, Rr, Rr^Vhc, Rr, Rr, Rr, Rr, Rr, Rr^Vhc, Ch, Ch, Gg, Gg, Gg, Gg, Gg, Gg, Gg, Gs^Fp, Gs^Fp, Gs^Fp, Gg, Rb, Gg, Gg, Rb, Sm, Rb, Ss, Rr, Rr, Sm, Ss^Vhs, Sm, Sm, Ss
Ww, Ww, Chw, Chw, Khw, Chw, Ww, Ww, Ww^Vm, Ww, Ww, Ww, Ww, Ww, Ww, Ww, Hh, Ww, Gg, Hh, Gg, Gg, Gg, Ww, Gg, Ch, Ch, Ch, Ch, Ch, Ch, Ch, Ch, Ch, Ch, Ch, Ch, Gg, Gg, Gg, Rr, Rr, Rr, Gg, Gg, Gs^Fp, Gs^Fp, Gg, Wwf, Gg, Gg, Hh, Ss, Ss, 6 Khs, Ss, Ss, Rr, Ss, Ss, Ss, Sm
Ww, Ww, Ww, Chw, Chw, Chw, Ww, Ww, Ww, Ww, Ww, Ww, Ww, Ww, Ww, Ww, Hh, Hh, Gg, Gg, Gg, Gg, Gg, Ww, Gg, Ch, Ch, Ch, Ch, Ch, Gg, Ch, Gg, Ch, Gg, Ch, Gg, Rr, Rr, Rr, Gg, Gg, Gg, Rr, Rr, Gs^Fp, Gs^Fp, Ww, Wwf, Rr^Vhc, Ww, Hh, Ss, Chs, Chs, Chs, Ss, Rr, Ss, Ss, Ss, Gg
Ww, Ww, Ww, Ww, Ww, Ww, Ww, Ww, Gg^Gvs, Gg^Gvs, Hh, Ww, Ww, Hh, Hh, Hh, Hh, Hh, Hh, Gg, Gg, Gg, Gs^Fp, Ww, Gg, Ch, Gg, Ch, Gg, Gg, Gg, Ww, Ww, Gg, Gg, Gg, Gg, Gg, Gg, Rr, Rr, Gg, Gg, Gg, Ch, Ww, Ww, Ww, Rb, Ww, Ww, Ww, Ss, Ss, Ss, Ss, Ss, Rr, Ss, Ss, Ss, Gg
Re, Ww, Re, Ww, Re, Ww, Gg^Gvs, Gg^Gvs, Gg^Gvs, Hh, Hh, Mm, Mm, Mm, Hh, Hh, Hh, Hh, Hh, Gs^Fp, Gs^Fp, Gg, Gs^Fp, Ww, Ww, Gg, Ww, Gg, Gg, Gg, Ww, Ww, Ww, Gg, Gg, Ww, Ww, Ww, Ww, Ww, Ww, Rp, Ww^Bw\r, Ww, Ww, Rr, Gg, Ww, Rb, Hh, Hh, Ww, Ww, Ss, Ww, Ss, Ww, Rr, Ss, Ss, Ss, Gg
Gg, Re, Gg^Eff, Re, Gg^Gvs, Re, Re, Gg^Gvs, Hh, Hh, Hh, Hh, Hh, Hh, Hh, Gg, Gg, Hh, Gs^Fp, Gs^Fp, Hh, Hh, Hh, Ww, Ww, Gg, Ww, Ww, Ww, Ww, Ww, Ww, Ww, Gg, Ww, Ww, Gg, Gg, Gg, Ww, Ww, Rr^Vhc, Ww, Ww^Bw\r, Rr, Rr, Rr, Rb, Hh, Hh, Gg, Gg, Gg, Ww, Sm, Ww, Ww, Wwf, Ww, Ss, Ss, Gg
Gg, Gg^Gvs, Gg^Gvs, Gg^Eff, Gg^Eff, Gg^Gvs, Gg^Gvs, Re, Re, Hh, Re, Hh, Hh, Hh, Hh, Hh, Gs^Fp, Gs^Fp, Hh, Hh, Hh, Hh, Hh, Hh, Hh, Ww, Gg, Gg, Gg, Gg, Rr, Gg, Gg, Ww, Ww, Ww, Gg, Gg, Gg, Gg, Gg, Ww, Gg, Gs^Fp, Gs^Fp, Rr, Rr, Rb, Gg, Gg, Gg, Gg, Gg, Sm, Sm, Ss, Ss, Rr, Ss^Vhs, Ww, Ww, Ss
Gg, Gs^Vh, Gg^Gvs, Gg^Gvs, Gg^Gvs, Gg^Eff, Gg^Eff, Gg^Gvs, Gg^Gvs, Re, Gll^Fp, Re, Re, Re, Re, Hh, Hh, Hh, Rr^Vhc, Hh^Es, Hh, Hh, Rr^Vhc, Hh, Hh, Hh, Hh, Hh, Rr, Rr, Gg, Rr, Rr, Gg, Gg, Gg, Gg, Gg, Gg, Gg, Gg, Gg, Gg, Gs^Fp, Gg, Gs^Fp, Rr, Rr, Rr, Gg, Gg, Gg, Gg, Gg, Gg, Sm, Rr, Rr, Sm, Ss, Sm, Ww
Gg, Gg^Gvs, Gg^Gvs, Gg^Gvs, Gg^Gvs, Gg^Gvs, Gg^Gvs, Gg^Eff, Gg^Eff, Gg^Gvs, Gll^Fp, Gll^Fp, Gll^Fp, Hh, Hh, Re, Re, Re, Hh, Rr, Rr, Rr, Hh, Hh, Rr, Hh, Hh, Hh, Rr, Hh, Hh, Hh, Hh, Hh, Hh, Hh, Hh, Hh, Hh, Rr, Rr, Rr, Rr, Gs^Fp, Gs^Fp, Gs^Fp, Rr, Rb, Gg, Rr, Rr, Gg, Rr, Rr, Rr, Rr, Gs^Fms, Gs^Vh, Gg, Sm, Sm, Ss
Gg, Gg^Gvs, Gg^Gvs, Gg^Gvs, Gg^Gvs, Gg^Gvs, Gg^Gvs, Gg^Gvs, Gg^Eff, Gg^Eff, Gll^Fp, Gll^Fp, Gll^Fp, Hh, Hh, Hh, Hh, Hh, Hh, Hh, Hh, Rr, Rr, Rr, Mm, Rr, Rr, Rr, Rr, Hh, Hh, Hh, Hh, Hh, Hh, Hh, Hh, Hh, Hh, Rr^Vhc, Hh, Hh, Rr, Gs^Fp, Gs^Fp, Rr, Co, Rb, Gg, Gg, Gg, Rr, Gg, Gg, Gg, Gg, Gg, Gs^Fms, Gs^Fms, Gs^Fms, Gs^Fms, Sm
Gg, Gg^Gvs, Gg^Gvs, Gg^Gvs, Gg^Gvs, Gg^Gvs, Gg^Eff, Gg^Eff, Gg^Gvs, Gg^Gvs, Gll^Fp, Gll^Fp, Gll^Fp, Hh, Hh, Hh, Hh, Hh, Hh, Hh, Hh, Mm, Mm, Mm, Mm, Mm, Mm, Mm, Hh, Rr, Rr, Rr^Vhc, Mm^Edb, Mm, Mm, Hh, Hh, Hh, Hh, Hh, Hh, Hh, Hh, Rr, Rr, Co, 4 Ko, Co, Rr^Vhc, Gs^Fp, Gg, Rr, Gg, Gg, Gg, Gg, Gg, Gg, Gs^Fds, Gs^Fms, Gs^Fms, Gg
Gg^Eff, Gg^Gvs, Gg^Gvs, Gg^Gvs, Gg^Eff, Gg^Eff, Gg^Gvs, Gg^Gvs, Gg^Gvs, Gg^Gvs, Gll^Fp, Gll^Fp, Gll^Fp, Mm, Mm, Mm, Hh, Hh, Hh, Hh, Mm, Mm, Mm, Mm, Mm, Mm, Mm, Mm, Mm, Mm, Rr, Mm^Edb, Mm, Mm, Mm, Mm, Mm, Mm, Mm, Mm, Hh, Hh, Hh, Gs^Fp, Gg, Co, Co, Co, Gg, Gg, Gg, Rr, Gg, Gg, Gg, Gs^Fms, Gg, Gg, Ce, Gg, Gs^Fms, Gg
Gg^Gvs, Gg^Eff, Gg^Eff, Gg^Eff, Gg^Gvs, Gg^Gvs, Gg^Gvs, Gg^Gvs, Gg^Gvs, Gg^Gvs, Gll^Fp, Mm, Mm, Mm, Hh, Hh, Hh, Mm, Mm, Mm, Mm, Mm, Mm^Edb, Mm, Mm, Mm, Mm, Mm, Mm, Mm, Rr, Mm, Mm, Mm, Mm^Edb, Mm, Mm, Mm, Mm, Mm, Mm, Hh, Hh, Hh, Gg, Rr^Vhc, Gg, Rp, Rr, Rr, Rr, Rr, Gg, Gg, Gg, Gg, Gg, Ce, Ke, Ce, Gg, Gg
Gg^Gvs, Gg^Gvs, Gg^Gvs, Gg^Eff, Gg^Eff, Gg^Gvs, Gg^Gvs, Gg^Gvs, Gg^Eff, Gg^Eff, Mm, Mm, Mm, Mm, Hh, Rr^Vhc, Rr^Vhc, Mm^Edb, Mm, Mm, Mm, Mm^Dr, Rr^Vhc, Mm^Es, Mm, Mm, Mm, Mm, Mm, Rr, Mm, Mm, Mm^Edb, Mm^Es, Rr^Vhc, Mm^Edt, Mm^Edt, Mm, Mm, Mm, Mm, Mm, Hh, Hh, Gg, Gg, Gs^Fp, Gg, Gg, Gg, Gg, Rr, Rr, Gs^Fms, Gs^Fms, Gg, Gs^Fms, Ce, Ce, Ce, Gs^Fms, Gg
Gg^Gvs, Gg^Gvs, Gg^Gvs, Gg^Gvs, Gg^Gvs, Gg^Eff, Gg, Gg^Eff, Mm, Mm, Mm, Mm, Mm, Mm, Hh, Mm, Mm, Mm, Mm, Mm, Mm, Mm, Mm, Mm^Dr, Mm, Mm, Mm, Mm, Mm, Rr, Mm, Mm, Mm, Mm^Edb, Mm, Mm^Edb, Mm, Mm, Mm, Mm, Mm, Mm, Hh, Hh, Hh, Gg, Gg, Gg, Gg, Gg, Gg, Gs^Fp, Rr, Rr, Rr, Rr, Rr, Rr, Rr, Rr, Rr, Gg
Gg, Gg^Gvs, Gg, Hh, Gg, Hh, Hh, Hh, Hh, Mm, Mm, Mm, Mm, Mm, Mm, Mm, Mm, Mm, Mm, Mm, Mm, Mm, Mm, Mm, Mm, Mm, Mm, Mm, Rr, Rr, Mm, Mm, Mm, Mm, Mm, Mm, Mm, Mm, Mm, Mm, Mm, Mm, Mm, Hh, Hh, Gg, Gg, Gg, Gs^Fp, Gs^Fp, Gg, Gs^Fp, Rr, Gg, Gg, Gg, Gg, Gs^Fms, Gg, Gs^Fms, Gg, Rr
