border_size=1
usage=map

Rr, Hh, Hh, Hh, Hh, Rr^Vhc, Rr, Hh, Hh, Hh, Hh, Hh, Hh, Hh, Mm, Mm, Mm, Mm, Mm, Mm, Mm, Mm
Hh, Rr, Rr, Hh, Hh, Hh, Rr, Hh, Hh, Hh, Hh, Hh, Hh, Hh, Hh, Hh, Mm, Mm, Mm, Mm, Hh, Hh
Hh, Hh, Hh, Rr, Rr, Hh, Rr, Hh, Hh, Hh, Hh, Hh, Hh, Hh, Hh, Hh, Hh, Hh, Hh, Hh, Hh, Hh
Hh, Hh, Hh, Hh, Rr, Ch, Ch, Ch, Ch, Ch, Ch, Ch, Ch, Ch, Ch, Hh, Ch, Hh, Hh, Hh, Hh, Hh
Hh, Hh, Hh, Hh, Rr, Ch, Ch, Ch, Rr^Vhc, Ch, Rr, 1 Kh, Rr, Ch, Rr^Vhc, Ch, Ch, Hh, Rr, Rr, Rr, Rr
Hh, Hh, Hh, Hh, Gg, Ch, Ch, Rr, Rr, Rr, Rr, Rr, Rr, Rr, Rr, Ch, Ch, Rr, Gg, Gg, Gg, Rr^Vhc
Ww, Gg, Gg, Gg, Gg, Ch, Ch, Rr, Rr, Rr, Rr, Rr, Rr, Rr, Rr, Ch, Ch, Gg, Gg, Gg, Gg, Gg
Gg, Ww, Ww, Ww, Gg, Ch, Ch, Rr, Rr^Vhc, Rr, Rr, Rr, Rr, Rr, Rr^Vhc, Ch, Ch, Gg, Gg, Gg, Gg, Gg
Gg, Gg, Gg, Ww, Gg, Ch, Ch, Ch, Ch, Ch, Ch, Ch, Ch, Ch, Ch, Ch, Ch, Gg, Gg, Gg, Rr, Rr
Gg, Gg, Gg, Ww, Gg, Ch, Ch, Ch, Ch, Ch, Gg, Ch, Gg, Ch, Gg, Ch, Gg, Rr, Rr, Rr, Gg, Gg
Gg, Gg, Gs^Fp, Ww, Gg, Ch, Gg, Ch, Gg, Gg, Gg, Ww, Ww, Gg, Gg, Gg, Gg, Gg, Gg, Rr, Rr, Gg
Gs^Fp, Gg, Gs^Fp, Ww, Ww, Gg, Ww, Gg, Gg, Gg, Ww, Ww, Ww, Gg, Gg, Ww, Ww, Ww, Ww, Ww, Ww, Rp
Hh, Hh, Hh, Ww, Ww, Gg, Ww, Ww, Ww, Ww, Ww, Ww, Ww, Gg, Ww, Ww, Gg, Gg, Gg, Ww, Ww, Rr^Vhc
